# 4
. 0
, 1
; 2

########
#.#....#
#.#,#,.#
#.#;#,.#
#.#,#,.#
#...#..#
########

end