// Auto generated map file.
-- Tiles
# 4
, 2
. 0
; 5
^ 1
~ 6

-- Map
#######################
#.#............^......#
#.#.#.^^.^...^^^......#
#.#.#^...^^^^^^^......#
#.#.#^.^^....^.^......#
#...#.....^^...^......#
#####..~~~~~~^........#
#...#.~~~~~~~~........#
#.~~~~~~~~~~~~........#
#.~~~~~~~~~~..........#
#..~~~~~~~...~~.......#
#^.........~~~~.......#
#######################

-- Entities
Animal
facing -2.9342
position 2.75406 4.16886
destination 21 1
end

Animal
facing 1.6872
position 10.8575 4.10027
destination 21 11
end


-- End