--	 Tiles
# 4
. 0
^ 1
, 2
; 5
--	 Map

################
#.#..;;;;;;;;;;#
#.#.#;^^;^;;;^^#
#.#.#^;;;^^^^^^#
#.#.#^;^^;;;;^;#
#...#;;;;;^^;;;#
################

-- Entities
-- 	end